"                                                                                                                      ",
"                                                                                                                      ",
"                                                                                                                      ",
"                                                                                                                      ",
"                                                                                       #################              ",
"                                                                                       #(°)(°)(°)(°)(°)#              ",
"                        ###############                                             ======================            ",
"                        ###############                                             ======================            ",
"                        ##   ##  ##  ##                                             ===( )====( )===( )===            ",
"                        ##   ##  ##  ##                                             ===( )====( )===(?)===            ",
"                        ###############                                              ........................         ",
"                        ##   ##  ##  ##                                                 ........................      ",
"                        ##   ##  ##  ##                                                    ......................     ",
"                        ###############                                                                               ",
"                        ##   ##  ##  ##                                                                               ",
"                        ##   ##  ##  ##                                            #                                  ",
"                        ###############                                           #^#                                 ",
"                       #####       #####                                         #(°)#                                ",
"                       #####       #####                                         #(°)#                                ",
"                       #####       #####                                     ############                             ",
"                         ......................                              ##   ##   ##                             ",
"                            .....................                            ##   ##   ##                             ",
"                                ...............                              ############                             ",
"                                  ..............                             ##   ##   ##                             ",
"                                    ..............                           ##   ##   ##                             ",
"                                     ..............                          ############                             ",
"                                                                      ########   ##   ########                        ",
"                                                                      ########   ## * ########                        ",
"                                                                       ..........................                     ",
"                                                                          ........................                    ",
"                                                                            ........................                  ",
"                                                                              ......................                  ",
"                                                                                     .............                    ",
"                                                                                         ............                 ",
"                                                                                                 .                    ",
"                                                                                                   .                  ",
"                                                                                                                      ",
"                                                                                                                      ",